A	AH
A(2)	EY
BACK	B AE K
BACK	B AE K
BUS	B AH S
BUS	B AH S
CLOSE	K L OW S
CLOSE(2)	K L OW Z
DOWN	D AW N
GO	G OW
HELLO	HH AH L OW
HELLO(2)	HH EH L OW
HEY	HH EY
HI	HH AY
IS	IH Z
IT	IH T
JOHN	JH AA N
LIKE	L AY K
ME	M IY
MUSIC	M Y UW Z IH K
NEXT	N EH K S T
NEXT(2)	N EH K S
OPEN	OW P AH N
PAUSE	P AO Z
PLAY	P L EY
PLEX	P L EH K S
SHOW	SH OW
SONG	S AO NG
STOP	S T AA P
THE	DH AH
THE(2)	DH IY
TIME	T AY M
TIMES	T AY M Z
TODAY	T AH D EY
TURN	T ER N
UP	AH P
VOLUME	V AA L Y AH M
WEATHER	W EH DH ER
WHAT	W AH T
WHAT(2)	HH W AH T
WHAT'S	W AH T S
WHAT'S(2)	HH W AH T S
WHEN	W EH N
WHEN(2)	HH W EH N
WHEN(3)	W IH N
WHEN(4)	HH W IH N
